1. able — способный
able-bodied — здоровый физически
ability — способность
enable — давать возможность
disable — лишать возможности
2. absence — отсутствие
absent — отсутствующий
absentee — отсутствующий / прогульщик
absent-minded —рассеянный
absent-mindedly — рассеянно
3. abstract — абстрактный
attract — притягивать / привлекать
attractive — привлекательный
contract — подписывать контракт
subtract — вычитать / отнимать
4. abnormal — ненормальный
abnormality — отклонение
norm — норма
normal —нормальный
normality — нормальность
5. accept — принимать
acceptable — приемлемый
acceptably — приемлемо
acceptance — прием
accepted — общепринятый
6. access — доступ
accessible — доступный
accessibility — доступность
accession — восхождение на престол
accessory — оснастка
7. accommodate — размещать
accommodation — место для проживания
accommodating — услужливый
commodity — товар
commodious — просторный
8. accord — согласовываться
accordingly — соответственно
according to — в соответствии (с чем-то)
accordance — соответствие
accordion — баян / аккордеон
9. act — действовать
an act — акт
acting — игра актеров
action — мера / действие
active — активный
actor — актер
actual — фактический
10. adapt — приспосабливаться
adaptable — приспосабливающийся
adaptor — адаптер
adaptation — переналадка / изменение
apt — точный / подходящий
aptitude — пригодность
11. adjoin — находиться рядом
adjoining — соседний / прилегающий
join — присоединяться / вступать
a join — соединение
joint — совместный
12. administer — руководить / предписывать
administration — администрация
administrator — администратор
minister — министр
ministry — министерство
13. admire — восхищаться
admiration — восхищение
admiring — восхищающийся
admiringly — восхищенно
admirer — поклонник
14. admission — допуск
admit — сознаваться / впускать
admittedly — можно предположить / предположительно
mission — миссия
commission — комиссия
15. adverse — неблагоприятный
adversary — противник
adversity — трудности
averse — неохотный / нежелающий
aversion — отвращение
16. advice — совет
advise — советовать
advisable — разумный
adviser — советник
17. affirm — подтверждать
affirmative — утвердительный
firm — твердый
firmness — твердость
infirm — больной / нездоровый
18. aggravate — усугублять
grave — серьезный
gravity — гравитация
gravely — серьезно
gravitational — гравитационный
19. air — воздух
air-conditioner — кондиционер
aircraft — самолет
airing — проветривание
airspace — воздушное пространство
20. alarm — тревога
alarm-clock —будильник
alarming — вызывающий тревогу
alarmingly — тревожно
alarmist — паникер
21. alter — изменить(ся)
alteration — изменение
alternate — чередоваться
alternative — альтернативный
an alternative — альтернатива
22. amend — вносить поправку / улучшать
amends — компенсация
amendment — поправка
mend — ремонтировать
commend — хвалить
23. ample — широкий
amplifier — усилитель
amplify — усиливать
amplification — увеличение / расширение
amply — широко / в достаточной мере
24. amuse — развлекать
amused — развеселившийся
amusement — развлечение
amusing — забавный / смешной
amusingly — смешно / забавно
25. art — искусство
artful — хитроумный / искусный
artist — художник
artificial — искусственный
artistry — мастерство
26. back — спина
aback — в сочетании «врасплох»
backing — поддержка
backbiting — злословие
back pay — задержка выплаты (зарплаты)
backward — отсталый
27. bank — банк
bank account — счет в банке
banker — банкир
banking — банковское дело
bankrupt — банкрот / обанкротиться
28. bare — голый
to bare — оголять
barefoot — босой 
barefooted — босиком
barely — едва
29. base — основание / база
baseless — безосновательный
basement — подвал
basic — основной
basis — основа
30. bath — ванна
bathe — купаться
bathroom — ванная комната
bathing suit — купальный костюм
bather — купающийся
31. bed — кровать
bedclothes — постельное белье
bedroom — спальная комната
bedridden — прикованный к постели
bedspread — покрывало
32. birth — рождение
birth control (contraception) — контрацепция
birthday — день рождения
birth rate — рождаемость
birthplace — место рождения
33. black — черный
blackcurrant — черная смородина
blackout — потеря сознания
blackmail — шантажировать
blackboard — классная доска
34. blood — кровь
blood donor — донор крови
blood pressure — кровяное давление
bloodshed — кровопролитие
blood poisoning — заражение крови
35. book — книга
bookcase — книжный шкаф
booking — бронирование (мест,билетов)
bookshop — книжный магазин
bookkeeping — бухучет
36. brain — мозг
brain drain — «утечка мозгов»
brainless — безмозглый
brainy — умный
brainwave — отличная идея
37. breath — дыхание
breathe — дышать
breather — передышка
breathless — запыхавшийся
breathtaking — захватывающий дух / увлекательный
38. brief — краткий
briefs — трусики
briefcase — портфель
briefing — брифинг / пресс-конференция
briefly — коротко
39. broad — широкий
broadcast — вещать / вести передачу
a broadcast — радиопередача
broaden — расширять
broadly — широко / в общих чертах
40. brutal — жестокий
brutality — жестокость
brute — скотина
brutish — скотский
brutalize — доводить до звероподобного состояния
41. capture — захватывать (в плен)
the capture — захват
captivity — плен / неволя
captivate — пленить / очаровать
captive — пленный
42. саге — заботиться
the саге — осторожность / забота
careful — внимательный
careless — невнимательный
carelessness — невнимательность
43. cast — бросать
the cast — состав исполнителей
casting — подбор актеров / кастинг
cast-iron — чугун
downcast — удрученный
44. catch — получить / схватить
catch up — догнать
catching — заразный
catchy — легко запоминающийся
catch-phrase — модное словечко
45. cave — пещера
cavity — полость
excavate — раскапывать
concave — вогнутый
caveman — пещерный человек
46. cent — цент
per cent — процент
centimetre — сантиметр
century — век / столетие
centigrade — по Цельсию
47. centre — центр
central — центральный
central heating — центральное отопление
centralize — централизовать
egocentric — эгоцентричный
48. certain — уверенный / некоторый
certainly — конечно
certainty — уверенность
certificate — сертификат / справка
certify — подтверждать
49. civil — гражданский / вежливый
civilian —штатский / гражданский
civilize — цивилизовать
civilized — цивилизованный
civilization — цивилизация
50. class — класс (в школе)
class — класс (в обществе)
classical — классический
classification — классификация
classify — классифицировать
51. clean — чистый
to clean — чистить
vacuum cleaner — пылесос
cleanse — обработать (рану) / чистить
cleanliness — чистоплотность
52. close — близкий
to close — закрывать
a close — конец
closed — закрытый
close down — закрывать
closeness — близость
53. command — просить / приказывать
commander-in-chief — главнокомандующий
commandment — заповедь
commanding — господствующий
commando — военный отряд
54. compare — сравнивать
comparison — сравнение
comparative — сравнительная степень (прилагательных)
comparable — сравнимый
comparatively — сравнительно
55. compete — конкурировать
competition — соревнование / конкурс
competitive — конкурентоспособный
competitor — конкурент
competent — компетентный
56. compose — составлять / сочинять
composer — композитор
composition — состав (химический)
composure — спокойствие
composed — спокойный / хладнокровный
57. comprehend — понимать
comprehension — понимание
comprehensive — исчерпывающий / обширный
apprehensive — предчувствующий плохое
apprehension — дурное предчувствие
58. compulsion — принуждение
compulsive — принудительный
compulsory — обязательный
impulse — импульс
repulsive — отталкивающий
59. confection — кондитерский отдел
confectionery — кондитерские изделия
infection — инфекция
infect — заражать
defect — дефект / недостаток
60. confide — довериться / сообщить
confidence —уверенность / конфиденциальность
confidential — конфиденциальный
confident — уверенный
diffident —неуверенный в себе
61. conform — соответствовать
conformist — конформист
reform — реформа
reformer — реформатор
deform — деформировать
62. confuse — перепутать
confusion — перепутывание
confusing — запутанный
fuse — плавкий предохранитель
refuse — отказаться
transfusion — переливание (крови)
63. conserve — сохранять
conservatism — консерватизм
conservative — консервативный
reserve — бронировать
reservation — оговорка
64. consider — считать
considerable — значительный
considerate — внимательный / предупредительный
consideration — рассмотрение / обсуждение
inconsiderable — незначительный
65. consist — состоять
consistent — последовательный
insist — настаивать
insistent — настойчивый
resist — сопротивляться
66. constrain — навязывать / заставлять
constraint — ограничение
strain — растянуть (мышцу)
strained — натянутый / напряженный
restrain — ограничивать
67. consult — консультироваться
consultant — консультант
consultation — консультация
consulting room — кабинет врача
insult — оскорбить
68. continue — продолжать
continuation — продолжение
continual — непрерывный
continually — постоянно
continuous — непрерывный
69. contrast — контраст
contrary — противоположный
contradictory — противоречивый
contradiction — противоречие
contravene — нарушать
70. convene — созывать
convenience — удобство
convenient — удобный
convention — условность / конвенция
conventional — традиционный
71. convert — преобразовать
convertible — конвертируемый
divert —изменить направление
extrovert — экстраверт
introvert — интроверт
72. correct — правильный
to correct — исправлять
correction — коррекция / изменение
direct — прямой
direction — направление
to direct — направить
73. count — считать
countable noun —исчисляемое существительное
account — сообщение
accountant — бухгалтер
accountable — подотчетный
74. acquire — получить / приобрести
acquisition —приобретение
require — требовать
requirement — требование
inquire — справляться / получать информацию
75. court — суд
courteous — вежливый
courtesy — вежливость
courthouse — здание суда
courtyard — двор
76. create — творить
creation — создание / творение
creative — творческий
creator — творец
creature — существо (живое)
77. credit — кредит
credible — правдоподобный
credibility — правдоподобие
creditable — делающий честь (кому-то)
credulous — доверчивый / легковерный
78. critic — критик
critical — критический
critically — критически
criticism — критика
criticize — критиковать
79. cross — пересекать
a cross — крест
cross oil' — вычеркивать
crossroads — перекресток
crossword — кроссворд
80. custom — обычай
customs — таможня
customary — обычный / привычный
customer — клиент
custom-made — сделанный на заказ
81. cut — резать
cutback — сокращение рабочего персонала
cutlery — ножевые изделия
cutter — резец / фреза
cutting — черенок / вырезка из газеты
82. day — день
daybreak — рассвет
daydream — мечтать
daytime — дневное время
daylight —дневной свет
83. dead — мертвый
deaden — заглушать / ослаблять
deadline — предельный срок
deadlock — тупик
deadly — смертельный
84. deceit — обман
deceitful —обманчивый
deceive — обманывать
deception — обман
deceptive — обманчивый
85. decide — решать
decided — явный
decidedly — решительно / очевидно
decision — решение
decisive — решающий
86. decorate — украшать
decoration — украшение
decorative — декоративный
decorator — декоратор
decorous — пристойный
87. defend — защищать
defence — защита
defenceless — беззащитный
defendant — ответчик (в суде)
defensive — оборонительный
88. define — определять
definable — определимый
the definite article — определенный артикль
definition — определение
definitive — окончательный
89. denounce — осуждать / доносить
announce — объявлять
announcement — объявление
pronounce — произносить
renounce — отказываться
90. depend — зависеть
dependable — надежный
dependant — иждивенец
dependent — зависящий
independent — независимый
91. depose — свергать
repose — отдых / покой
impose — устанавливать / налагать
pose — позировать
suppose — предполагать
92. derive — получать / заимствовать
derivation — происхождение
arrive — прибывать
arrival — прибытие
derivative — заимствованный
93. descend — спускаться
descendant — потомок
descending — убывающий
descent — происхождение
ascent — восхождение
94. deserve — заслуживать
deservedly — заслуженно
serve — служить
service — служба / сервис
serving — порция (пищи)
95. design — придумывать
designate — называть / обозначать
designer — дизайнер
designation — название
resign — уйти в отставку
96. destruction — разрушение
destructive — разрушительный
destroy — разрушать
construction — строительство
construct — строить
97. determine — определять
determination — определение / решимость
determined — решительный / твердый
terminate — закончить
terminal — терминал
98. devote — посвящать
devoted — преданный
devotion — привязанность / преданность
devotee — энтузиаст
vote — голосовать / голосование
99. dictate — диктовать
dictation — диктант
dictator — диктатор
dictatorship — диктатура
dictionary — словарь
100. differ — отличаться
difference — разница
different — различный
differently — по-другому / иначе
differentiate — различать(ся)
101. dignity — достоинство
dignify — величать / удостаивать
dignified — с чувством собственного достоинства
dignitary — чиновник / сановник
indignation — возмущение
102. diminish — уменьшать
diminutive — уменьшительный
minute — минута
the minutes — протокол
miniature — миниатюра / маленький
103. direct — прямой
to direct — направлять / обращать
direction — направление
directive — директива
directory — справочник (телефонный)
104. disagree — не соглашаться
disagreement — разногласие
agree — соглашаться
agreeable — приятный
agreement — соглашение
105. dispense — обходиться без чего-то
dispensable — то, без чего можно обойтись
spend — тратить
expend —тратить
expense — расход
106. dispose — продать / избавиться
disposed — относящийся (плохо или хорошо)
disposal — распоряжение
disposition —нрав / настроение
proposition — предложение
107. diverse — различный / разнообразный
diversion — развлечение
diversity — разнообразие
diversify — вносить разнообразие
version — версия
108. distribute — распределять / распространять
distributor — дистрибьютор
distribution — распределение
attribute — объяснять / приписывать (чему-то)
contribution — взнос / вклад
109. divide — делить
dividend — дивиденд
division — деление
divisible — делимый
divisor — делитель
110. dominate — доминировать / господствовать
domination — доминирующее положение
dominating — имеющий влияние
domineering — властный / деспотичный
dominant — влиятельный
111. doubt — сомнение
doubtful — сомнительный
doubtless — несомненный
undoubted — несомненный
undoubtedly — несомненно
112. down — вниз
downcast — удрученный / печальный
downfall — падение
downhearted — удрученный / расстроенный
downstairs — вниз по лестнице
113. draw — провести / тянуть
a draw — ничья
drawback — препятствие / недостаток
drawer — выдвижной ящик (стола)
drawing — чертеж
withdraw — убрать / взять назад
withdrawal — вывод (войск)
114. drive — вести машину / гнать
driven — приводимый
a drive — катание на машине
driveway — подъездная дорога
driver — водитель
driving licence — водительские права
115. dress — платье / одеваться
dress up — нарядиться
dresser — человек, одевающийся плохо или хорошо
dressing — приправа
dressing-down — нахлобучка / головомойка
116. during — предлог «в течение» / во время
durable — долговечный
durability —долговечность
duration — продолжительность
endure — вытерпеть / вынести
117. dust — пыль
dusty — пыльный
dustbin — мусорный контейнер
duster — тряпка
dustpan — совок для сора
118. ear — ухо
earlobe — мочка уха
earphone — наушник
earring — серьга
earshot — расстояние слышимости
119. earth — земля
earthen — глиняный
earthly — земной
earthquake — землетрясение
unearthly — очень поздний / ранний (час)
120. ease — легкость
easily — легко
easy — легкий
easy-going — беззаботный
uneasiness — беспокойство
121. economy — экономика
economic — экономический
economically — экономически
economical — экономичный
economize — экономить
122. edge — кромка / ребро (предмета)
edgeways — острием вперед
edging — кайма
edgy — раздраженный
edged-tool — острый инструмент
123. edit — редактировать
edition — издание
editor — редактор
editorial — редакторский
editorship — редакция / редактирование
124. effect — влияние
effective — эффективный
effectively — эффективно
to effect — производить
effectual — эффективный
125. elect — избирать / выбирать
elected — избранный
election — выборы
elector — избиратель
electorate — электорат
126. electric — электрический
electrical — электрический
electrician — электрик
electricity — электричество
electrode — электрод
127. embarrass — смущать
embarrassed — испытывающий стыд
embarrassing — смущающий / вызывающий стыд
embarrassment — затруднение / стыд
128. emerge — появляться
emergency — аварийное положение / критическое обстоятель­ство
emergent — восходящий
merge — сливаться / объединяться
submerge — погружаться
129. emigrate — эмигрировать
emigre — политический эмигрант
migrate — мигрировать
immigrant — иммигрант
emigration — эмиграция
130. emit — выделять / излучать
emission — излучение / эмиссия
mission — миссия
transmission — передача
submit — подчиняться / представлять
131. employ — принимать на работу
employee — служащий / наемный работник
employer — работодатель
employment — занятость
unemployment — безработица
132. engage — задействовать / занять работой
engaged — занятый
engagement — помолвка
engaging — обаятельный
disengage — расцепить
133. engine — двигатель
engineer — инженер
to engineer — позаботиться / устроить
engineering —машиностроение
engine-driver — машинист
134. equal — равный
equality — равенство
equally — поровну
equal sign — знак равенства
equilibrium — равновесие
135. err — ошибаться
erratic — сумасбродный
erroneous — ошибочный
erroneously — ошибочно
error — ошибка
136. exact — точный
to exact — требовать
exactness — точность
exacting — строгий
exactly — точно / вот именно
137. exam — экзамен
examination — экзамен
medical examination — медосмотр
examine — проверять
examiner — экзаменатор
138. excite — увлекать / возбуждать
excited — взволнованный
excitedly — взволнованно
excitement — волнение
exciting — увлекательный
139. excel — быть выдающимся
excellence — высокое мастерство
Excellency — ваше превосходительство
excellent — отличный
excellently — великолепно / отлично
140. except — за исключением
excepting — за исключением
exception — исключение
exceptional — исключительный
exceptionally — необычно / исключительно
141. exclaim — воскликнуть
exclamation — (радостный) возглас
exclamation mark — восклицательный знак
claim — заявлять / претендовать
proclaim — объявлять
142. exclude — исключать
excluding — исключая
exclusion — исключение
exclusive — эксклюзивный / исключающий
exclusively — исключительно
143. execute — осуществлять
execution — выполнение
executioner — палач
executive — руководитель высокого ранга
executor — душеприказчик
144. exceed — превышать
exceedingly — очень / чрезвычайно
proceed — продолжать
proceeding — судебное разбирательство
procedure — процедура
145. exhaust — истощать
exhausted — усталый (очень)
exhausting — изнурительный
exhaust pipe — выхлопная труба
exhaustion — изнеможение
146. exist — существовать
existence — существование
existing — существующий
existentionalism — экзистенционализм
147. expand — увеличивать(ся)
expanse — простор / ширь
expansion — развитие / расширение
expansionist — экспансионистский
expansive — обширный / откровенный
148. expect — ожидать / предполагать
life expectancy — продолжительность жизни
expectant mother — беременная женщина
expectation — ожидание
unexpected — неожиданный
149. expend — тратить
expense — расходы
expensive — дорогой
expenditure — расход
expensively — с большими расходами
150. expose — подвергать / обнажать
exposition — выставка
exposure — подвергание (чему-то)
impose — устанавливать / налагать
oppose — возражать / противиться
151. express — выражать
an express — экспресс
expression — выражение
expressionless — ничего не выражающий
expressive — экспрессивный
152. extend — доходить / продлить
extension — продление / пристройка
extent — объем / мера
tension — напряженность
intensive — интенсивный
153. extort — вымогать
extortion — вымогательство
extortionate — грабительский
torture — пытка
to torture — пытать / мучить
154. eye — глаз
eyebrow — бровь
eye-catching — броский
eyesight — зрение
eye-witness — свидетель
155. face — лицо
face up — встретить / преодолеть
facial — лицевой
surface — поверхность
efface — стирать
156. fact — факт
factor — фактор
factory — фабрика
factual — фактический
faction — фракция (партии)
157. fail — завалить / не сделать
failed — неудачник
a failing — недостаток
failing — ухудшающийся
failure — неудача / банкротство
158. false — неверный
false alarm — ложная тревога
falsehood — ложность
false start — фальстарт
falsify — фальсифицировать
falsity —ложность
159. family — семья
familial — семейный
familiar — знакомый
familiarity — фамильярность
familiarize — познакомиться поближе
160. far — далекий
afar — издали
faraway — дальний / рассеянный
farther — дальше
far-reaching — далеко идущий
161. fate — судьба
fated — обреченный
fateful — судьбоносный
fatal — роковой / фатальный
fatality — рок / смерть
162. father — отец
Father Christmas — Дед Мороз
father-in-law — тесть / свекор
fatherless — оставшийся без отца
fatherly — отеческий
163. favour — благосклонность / покровительство
to favour — благоприятствовать
favourable — благоприятный
favourite — любимый
favouritism — фаворитизм
164. fear — страх
to fear — бояться
fearful — страшный / испуганный
fearless — бесстрашный
fearsome — страшный
165. fertile — плодородный
fertilize — удобрять
fertilization — оплодотворение
fertilizer — удобрение
fertility — богатство
166. faith — вера
faithful — верный
faithfully — правдиво
yours faithfully — с совершенным почтением
167. fill — заполнять / наполнять
fill in — заполнять
fill out — полнеть
filling — пломба
filling station — заправочная станция
168. feel — чувствовать
feel like doing — хотеть что-то делать
feel oneself — чувствовать себя
feeling — чувство
feeler — щупальце / зонд
unfeeling — бесчувственный
169. feminine — женский
femininity — женственность
feminism — феминизм
feminist — феминистка
170. final — последний
a final — финал
finale — финал (музыкальный)
finalist — финалист
finalize — окончательно решить
finally — наконец
171. fire — огонь / пожар
to fire — выстрелить
fire engine — пожарная машина
fire extinguisher — огнетушитель
fireplace — камин
firework — фейерверк
172. first — первый
first aid — первая помощь
first-class — первоклассный
first name — имя
first night — премьера
173. fish — рыба
to fish — ловить рыбу
fisherman — рыбак
fishing — рыбная ловля
fishing rod — удочка
174. to fit — подходить (по размеру)
fit — пригодный
fitness — физическая форма
fitful — порывистый
fitter — слесарь
175. fold — свернуть / сложить
fold up — свернуть деятельность
ten-fold — десятикратный
folder — папка
folding — складной
unfold — развернуть / раскрыть
176. follow — следовать
follow up — заниматься / расследовать
follower — последователь
following — следующий
follow-up — последующий
177. fool — дурак
foolish — глупый / дурацкий
foolishly — глупо / по-глупому
foolishness — глупость
foolproof — защищенный от неосторожного обращения
178. foot — ступня
football — фугбол
footing — опора для ног / прочное положение
footnote — подстрочная сноска
footpath — тропинка
footwear — обувь
179. force — сила
to force — вынуждать
forced — принудительный
forceful — напористый
enforce — проводить в жизнь / осуществлять
180. form — форма
formal — формальный
formality — формальность
format — формат
formation — образование
formulate — формулировать
181. found — образовывать / основывать
foundation — основа / фундамент
founder — основатель
to founder — затонуть
founding — создание / основание
182. fraction — доля (часть)
fracture — перелом
fragile — хрупкий
fragment — фрагмент
fragmented — фрагментированный / разбитый на части
183. free — свободный
to free — освобождать
freedom — свобода
free enterprise — свободное предпринимательство
freely — свободно
freestyle — вольный стиль
184. fresh — свежий
freshness — свежесть
freshen (oneself) — освежить(ся)
freshen up — освежиться
fresher — первокурсник
185. fright — страх
frighten — пугать
frightened — испуганный
frightening — страшный
frightful — ужасный
frightfully — безобразно
186. the front — фронт
front — передний
in front of smth — перед чем-то
frontal — фасад
frontier — граница
front line — линия фронта
187. fruit — фрукты
fruitful — плодотворный
fruition — осуществление
fruitless — бесплодный
fruity — мелодичный
188. full — полный
fulfil — выполнять
fullness — полнота
full stop — точка (в конце предложения)
full time — полный рабочий день
fully — полностью
189. gas — газ
to gas — отравить(ся) газом
gaseous — газообразный
gas mask — противогаз
gas burner — газовая горелка / конфорка
190. general — общий
a general — генерал
general election — всеобщие выборы
generalize — обобщать
generalized — общий
generally — вообще / обычно
191. generate — порождать / генерировать
generation — поколение / выработка
generator — генератор
generic — родовой
genetics — генетика
192. gold — золото
golden — золотистый
goldfish — золотая рыбка
gold plated — позолоченный
goldmine — «золотое дно»
193. good — хороший / добрый
goods — товары
good-looking — красивый
good-tempered — добродушный 
good-humoured — добродушный
goodbye — прощание / До свидания!
goodness — хорошее качество / доброта
194. grade — оценка / уровень
gradation — градация
gradual — постепенный
gradually — постепенно
graduate — заканчивать учебное заведение
postgraduate — аспирант
195. grand — великий / замечательный
grandeur — величие
grandfather — дедушка
grandmother — бабушка
grandiose — грандиозный
196. great — большой / великий
greatness — величие
great-grandfather — прадед
greatly — сильно
a great deal — много
197. green — зеленый
the green — зелень / лужайка
the Greens — партия «зеленых»
greenery — зелень
greengrocer’s — овощной магазин
greenhouse — оранжерея
198. ground — земля / причина
to ground — базировать
ground floor — первый этаж
grounding — основы
groundless — безосновательный
199. grow — расти / выращивать
grower — человек, выращивающий что-то
grow up — вырастать / становиться взрослым
grown-up — взрослый
growth — рост
200. guide — руководство / гид
to guide — руководствоваться / вести
guidebook — путеводитель
guiding — руководящий
guidance — руководство
201. habit — привычка
habitable — пригодный для проживания
habitation — проживание
habitual — привычный
inhabit — населять
inhabitant —житель / жилец
202. hair — волосы
haircut — стрижка / прическа
hairdo — прическа
hairdresser — парикмахер
hairy — волосатый
203. half — половина
half-price — полцены
half-time — перерыв между таймами / неполный рабочий день
halfway — на середине
half-hearted — слабый / нерешительный
204. hand — кисть руки
hand over — передавать
handcuffs — наручники
handful — горсть
handle — ручка
handshake — рукопожатие
handy — умелый
205. hang — висеть
hang out — вывешивать
hanger — вешалка (плечики)
hanging — повешение
hangover — похмелье
206. happy — счастливый
happily — счастливо
happiness — счастье
unhappy — несчастливый
mishap — неудача
207. hard — твердый
hardness — твердость
harden — отвердевать
hardly — вряд ли
hardship — трудности или лишения
208. haste — спешка / поспешность
hasten — ускорять / торопить
hasty — торопливый / опрометчивый
hastily — поспешно
hastiness — поспешность
209. head — голова
to head — возглавлять
headache — головная боль
headgear — головной убор
heading — заголовок
headlines — основные темы (новости)
210. heal — заживать / заживлять
healer — целитель
health — здоровье
healthy — здоровый
healthily — здоровым образом
211. hear — слышать
hearer — слушатель
hearsay — слухи
hearing — слух (орган) / слушание дела
hearing aid — слуховой аппарат
212. heart — сердце
heart attack — сердечный приступ
heartbeat — биение сердца
hearten — ободрять
heartbreaking — душераздирающий
213. to heat — нагревать
heat — тепло / жар
heat up — подогревать
heater — обогреватель / нагреватель
central heating — центральное отопление
214. heir — наследник
heiress — наследница
heirloom — наследственные вещи
inherit — наследовать
inheritance — наследие
heritage — наследие
215. high — высокий
high-heeled — на высоком каблуке
high-spirited — в хорошем настроении
highly — в высшей степени
high school — средняя школа
highway — шоссе
216. hold — держать
hold out — выдерживать
holder — владелец / держатель
holding — арендованный участок / холдинг
hold-up — грабеж
217. hope — надеяться
a hope — надежда
hopeful — надеющийся / подающий надежды
hopeless — безнадежный
hopelessly — безнадежно
218. horrible — ужасный
horribly — ужасно / страшно
horrid —ужасный
horrific — ужасный
horror — ужас
horrify — приводить в ужас
219. horse — лошадь
horseback — верхом на лошади
horseman —всадник
horsemanship — искусство верховой езды
horse-radish — хрен (растение)
220. hot — горячий
hot dog — хот-дог (булка с сосиской)
hotly — горячо
hotbed — парник / рассадник
hot-tempered — вспыльчивый
221. house — дом
housing — жилье
housewife — домохозяйка
household — семья / домашнее хозяйство
housework — работа по хозяйству
222. human — человеческий
humane — гуманный
humanism — гуманизм
humanity — человечество
human rights — права человека
223. humour — юмор
good humour — хорошее настроение
bad humour — плохое настроение
to humour — ублажать
humorous — юмористический
humorist — юморист
humourless — без чувства юмора
224. hunt — охотиться
hunting —охота
hunt down — поймать
hunter — охотник
huntsman — охотник
225. ice — лед
iceberg — айсберг
ice-cold — холодный как лед
ice hockey — хоккей на льду
ice-skating — катание на льду
icicle — сосулька
icy — ледяной
226. idea — идея / понятие
ideal — идеал / идеальный
idealize — идеализировать
ideally — идеально
idealist — идеалист
227. identity — личность / подлинность
identify — установить / опознать
identical — идентичный
identification — удостоверение личности
identity card — удостоверение личности
228. ill — больной
ill-advised — неблагоразумный
illness — болезнь
ill-fated — злополучный
ill-treat — жестоко обращаться
229. illuminate — освещать
illuminated — освещенный
illumination — освещение
illuminating — поясняющий
luminous — светящийся
230. illusion — иллюзия
illusory — иллюзорный
allusion — ссылка
delusion — заблуждение
delude oneself — заблуждаться
231. illustrate — иллюстрировать / показывать
illustration — иллюстрация
illustrative — иллюстрированный / наглядный
illustrious — известный
lustre — блеск
232. image — образ
imagine — представлять себе
imaginative — с богатым воображением
imagination — фантазия
imaginary — мнимый / воображаемый
233. immobile — неподвижный
mobile — подвижный
mobilize — мобилизовать
immobilize — сковывать / иммобилизовать
automobile — автомобиль
234. impartial — беспристрастный
partial — частичный / пристрастный
impartially — беспристрастно
impartiality — беспристрастность / справедливость
partially — частично
235. implicate — впутывать / вовлекать
implication — причастность
complicated — сложный
complication — осложнение
application — применение
applicable — применимый
236. import — импорт
to import — импортировать / иметь значение
important — важный
importance — важность
importer — импортер
237. impress — произвести впечатление
impression — впечатление
press — нажимать
the Press — пресса
pressure — давление
pressed — испытывающий нехватку
238. incidence — частотность
coincidence — совпадение
incident — происшествие
incidental — случайный / присущий
incidentally — между прочим
239. income — доход
incoming — входящий / поступающий
соте — приходить / прибывать
outcome — выход / исход
overcome — преодолеть
240. induce — заставлять / повлиять
inducement — побуждение / стимул
introduce — вводить
introduction — введение / внедрение
introductory — вводный
241. industry — промышленность
industrial — промышленный
industrialized — промышленно развитый
industrious — прилежный / трудолюбивый
industrialization — индустриализация
242. infinite — бесконечный
infinitesimal — бесконечно малый
infinitive — инфинитив
infinity — бесконечность
finite — ограниченный
243. inflame — воспламенять(ся) / возбуждать
inflamed — воспламененный / воспаленный
inflammable — воспламеняющийся
flame — пламя
inflammation — воспаление
244. inflect — склонять(ся) / спрягать(ся)
inflected — согнутый
flexible — гибкий
inflection — модуляция
inflexion — изменение
reflect — отражать
reflection — отражение
245. inform — информировать
information — информация
informative — информативный
informer — осведомитель
reform — перевоспитать / реформировать
246. initial — начальный
initially — первоначально
initiate — начинать
initiative — инициатива
the initials — инициалы
247. enquire — узнавать / расследовать
inquire — узнавать / расследовать
inquiring — пытливый
inquiry — расследование
inquisitive — любознательный / любопытный
require — требовать
248. insane — психически больной
insanity — сумасшествие
sane — психически здоровый
sanity — душевное здоровье
sanitary — санитарный
sanatorium — санаторий
249. insensitive — нечувствительный
sensitive — чувствительный
sentiment — чувство / настроение
sentimental — сентиментальный
sensual — сладострастный
250. inspect — проверять
inspection — инспекция
inspector — инспектор
expect — ожидать
unexpectedly — неожиданно
251. inspire — вдохновлять
inspiration — вдохновение
inspiring — вдохновляющий
expire — истекать
aspire — стремиться
252. insular — островной / замкнутый
insulate — изолировать (изолятором)
insulation — изоляция
isolate — изолировать / уединять
isolation — изоляция / отрыв
253. integral — неотъемлемый
integrate — интегрироваться)
integrity — честность
integration — интеграция
integrated — совместный
254. intense — сильный / интенсивный
intensely — сильно
intensive — интенсивный
intensify — усилить
tense — напряженный
255. liberal — либеральный / щедрый
liberalize — либерализовать
liberalization — либерализация
liberate — освобождать
liberation — освобождение
liberty — свобода
256. life — жизнь
life expectation — продолжительность жизни
lifeless — безжизненный
lifetime — время жизни
live — жить
lively — веселый
257. the light — свет
light — светлый
to light — зажигать
lighten — освещать / светлеть
lighter — зажигалка
lighting — освещение
lightning — молния
258. like — как
likely — вероятно
likelihood — вероятность
likeness — сходство
likewise — подобно / также
259. limit — ограничение / предел
to limit — ограничивать
limitation — ограничение
limited — ограниченный
limitless — безграничный
260. line — линия
line up — стать в ряд / в очередь
linear — линейный
linesman — судья на линии
liner — лайнер
261. literate — грамотный
literacy — грамотность
literal — буквальный
literally — буквально
illiterate — неграмотный
literature — литература
262. locate — найти / определить местоположение
local — местный
locally — на местном уровне / местами
locality — местность / район
location — местожительство
263. the lock — замок
to lock — закрыть на ключ
lock up — запереть / посадить (куда-то)
locker — шкафчик
lockup — камера
264. long — долгий / долго
no longer — уже не
longevity — долголетие
long-lasting — долговечный
long-sighted —дальнозоркий
long-term — долгосрочный
265. look — смотреть
look after smb — ухаживать за кем-то
look forward to smth — с нетерпением ожидать чего-то
looker-on — наблюдающий со стороны
lookout — бдительность / наблюдатель
looking-glass — зеркальце
266. to love — любить
the love — любовь
lovely — красивый
lover — любовник
loving — любящий
love affair — любовный роман
267. low — низкий
lowlands — низменность (рельефа)
lowly — низкий
to lower — опускать / снижать
low-paid — низкооплачиваемый
268. mad — сумасшедший
madden — сводить с ума
maddening — сводящий с ума
madman — душевнобольной / сумасшедший
madly — без ума
269. magnify — увеличивать
magnifying glass — увеличительное стекло
magnification — увеличение
magnitude — величина / важность
magnificent — великолепный
270. make — делать
the make — марка / тип
make out — рассмотреть / разобрать
make up —подкрашиваться
maker — изготовитель
making — изготовление
271. manage — справиться / управлять
manageable — выполнимый
management — управление
manager — директор / управляющий
managerial — руководящий
272. man — человек / мужчина
manhandle — обращаться (с кем-то)
manhole — люк (отверстия)
mankind — человечество
manly — мужественный / мужской
manned — с человеком на борту
273. mark — оценка / метка
to mark — отмечать
marked — заметный
marker — знак / указатель
marksman — снайпер / хороший стрелок
274. master — мастер / учитель школы
to master — овладевать
headmaster — директор школы
masterful — властный / мастерской
masterpiece — шедевр
mastery — мастерство
275. to mean — значить
means — средство
mean — (омоним) грубый / подлый
meaning — значение
meaningful — вразумительный
276. to measure — замерять / измерять
measure — мера / действие
measured — размеренный
measurement — замер / результат замера
tape-measure — рулетка
277. mechanic — механик
mechanical — механический
mechanically — механически / не думая
mechanism — механизм
mechanize — механизировать / автоматизировать
278. medic — медик
medical — медицинский
medication — лекарство / лечение
medicine — медицина / лекарство
medicinal —лекарственный
279. memory — память / воспоминание
memorize — заучивать наизусть
memorial — мемориал
memorable — памятный
commemorative — мемориальный
280. misjudge — неверно оценить / судить
to judge — судить / считать
judge — судья
judgement — суждение
judicious — разумный
281. mislead — вводить в заблуждение
lead — вести / возглавлять
leader — лидер
leadership — руководство
leading — ведущий
282. misunderstand — неправильно понять
understand — понимать
understanding — взаимопонимание
stand — стоять
stand-by — запасной
283. to match — согласовывать(ся)
match — матч
matched — подходящий
matching — подходящий
matchless — не имеющий равных / несравненный
284. morals — мораль
moral — моральный
morale — моральное состояние
morality — мораль / этика
moralize — читать мораль
285. motor — мотор / двигатель
motorbike — мотоцикл
motion — движение
motionless —неподвижный
motive — мотив
motivate — мотивировать
286. mount — возрастать / подниматься
mountain — гора
mountaineer — альпинист
mountaineering — альпинизм
mountainous — гористый
amount — объем / количество
287. move — двигать(ся)
the move — ход
movable — подвижный
movement — движение
movie — кинофильм
moving — трогательный
288. multiply — увеличивать(ся) / умножать
multiplication — умножение
multitude — множество
multiplicity — множество
multiple — многократный
289. nation — нация
national — национальный
nationalise — национализировать
nationalism — национализм
nationality — национальность
290. nature — природа
natural — природный / естественный
naturalist — натуралист
naturally — естественно / непринужденно
natural resources — природные ресурсы
291. a note — записка / заметка
note — заметить
notable — примечательный
noted — известный
notebook — записная книжка
292. observe — наблюдать
observer — обозреватель
observatory — обсерватория
observation — наблюдение
observance — соблюдение
293. obstruct — застопорить
obstruction — завал / обструкция
obstructive — обструктивный / препятствующий
constructive — конструктивный
structure — структура / структурировать
294. occupy — занимать
occupation — занятие / оккупация
occupant —житель / владелец-оккупант
occupier — владелец / житель
preoccupy — занимать / беспокоить
295. offence — оскорбление / наступление
offend — оскорбить
offender — правонарушитель
offending — раздражающий
offensive — оскорбительный
296. to open — открывать
open — открытый
opening — отверстие / дыра
openly — открыто
opening hours — часы работы
297. oppose — противиться / противостоять
opposed — противоположный
opposing — противоположный
opposite — противоположный
opposition — оппозиция / противник
298. organ — орган
organic — органический
organization — организация
organize — организовать
organized — организованный
299. pack — упаковывать
package — упаковывать
packaging — упаковка
packet — пакет / пачка / посылка
packing case — упаковочный ящик
300. part — часть
to pari — расставаться
partially — частично
participant — участник
parting — расставание
301. pass — проходить
pass away — умирать
a pass — перевал
passage — проход / коридор / отрывок
passer-by — прохожий
302. passion — страсть
passionate — страстный
passionately —страстно
passive — пассивный
the passive — страдательный залог
303. pendant — подвеска / кулон
pending — ожидающийся / висячий
pendulum — маятник (часов)
depend — зависеть / положиться
independent — независимый
304. perfect — совершенный
the perfect tense — совершенное время
perfectly — совершенно
perfection — совершенство
perfectionist — человек, стремящийся к совершенству
305. perception — восприятие
perceptive — остро воспринимающий / проницательный
perceptible — заметный
perceive — воспринимать
conceive — представить себе / придумать
conception — концепция
306. permit — разрешать
the permit — пропуск
permission — разрешение
permissible — допустимый
transmission — вещание / передача
307. persist — продолжаться / упорствовать
persistent — настойчивый
persistently — настойчиво
persistence — настойчивость
subsistence — существование / выживание
308. person — человек
personage — личность / персона
personal — личный
personally — лично
personify — олицетворять
personnel — персонал
309. perverse — порочный / ошибочный
perversion — извращение
pervert — извращать / совращать
a pervert — извращенец
perverted — извращенный
310. phrase — фраза
phraseology — фразеология
phrasal verbs — глаголы с частицами и фиксированными пред­логами
phrase book — разговорник
to phrase — выражать
311. pity — жалеть
take pity on smb — сжалиться над кем-то
pitiable — жалкий / несчастный
pitiful — жалкий
pitiless — безжалостный
312. plant — сажать
the plant — растение
plantation — плантация
planter — плантатор
transplant — пересаживать (орган)
313. plastic — пластмасса
plasticine — пластилин
plastic surgery — пластическая операция
plaster — штукатурка / пластырь
plaster of Paris — гипс
314. play — играть
a play — игра / пьеса
playboy — плейбой
playfully — игриво
playmate — товарищ / партнер
player — игрок
315. please — пожалуйста
pleased — довольный
pleasing — приятный
pleasure — удовольствие
pleasurable — приятный
pleasant — приятный
316. point — вопрос / точка
to point — направлять
point-blank — в упор / решительно
pointer — указатель / стрелка
pointless — бесполезный
317. popular — популярный
popularity — популярность
popularize — популяризовать
population — население
populous — густо населенный
318. pose — позировать
poser — позер
position — положение
positive — позитивный
positively — в самом деле
319. practical — практический
practice — практика
practicality — практика / практичность
practise —тренироваться / практиковаться
practicable — выполнимый
320. prefer — предпочитать
preferable — предпочтительный
preferably — предпочтительно
preference — предпочтение
confer — давать, присуждать / советоваться
conference — конференция
321. present — настоящий (о времени)
a present — подарок
to present — дарить
presentation — презентация
presently — скоро / вскоре
322. preserve — сохранять / консервировать
preserved — сохранившийся
preservation — сохранение
serve — служить
reserved — сдержанный
reserve — резерв / запас
323. presume — предполагать
presumption — предположение
presumptuous — самонадеянный
resume — возобновлять
consume — потреблять
324. pretend — делать вид, притворяться / претендовать
pretence — претензия / притворство
pretension — претензия / притворство
retention — сохранение
contention — спор
325. prevent — предотвращать / не допускать
preventive — превентивный / профилактический
prevention — предотвращение
invent — изобретать / придумывать
invention — изобретение
326. private — личный / частный
privation — лишения / трудности
a private — рядовой солдат
privatize — приватизировать
privatization — приватизация
327. produce — производить
producer — производитель
induce — заставлять / повлиять
reduce — доводить / сокращать
introduce — вводить / представлять
conducive — способствующий
328. progress — прогресс / успех
to progress — продвигаться
progression — прогрессия / продвижение
progressive — прогрессивный
repression — регрессия
329. pronounce — произносить
pronounced — ярко выраженный
pronunciation — произношение
pronouncement — заявление
denounce — обвинять / доносить
renounce —отказываться
330. proof — доказательство
prove — доказывать
proven — проверенный / доказанный
improve — улучшать(ся)
approve — одобрять
331. proper — адекватный / настоящий
proper noun — имя собственное
property — собственность
to appropriate — присваивать
appropriate — подходящий / уместный
332. prospect — перспектива
to prospect — вести разведку
prospective — потенциальный
circumspect — осмотрительный
spectator — зритель
333. protect — защищать
protection — защита
protective — защитный / покровительственный
detect — обнаруживать
detective — детектив
334. provide — обеспечивать / снабжать
provided — при условии, что
providing — при условии, что
provision — снабжение
provisional — временный
335. the public — публика / люди
public — общественный / публичный
publication — публикация
publicity — реклама / гласность
publicize — публиковать
336. purity — чистота / непорочность
purify — очищать
puritan — пуританский
pure — чистый
purely — всего лишь
337. quality — качество
qualitative — качественный
qualify — квалифицироваться)
qualification — квалификация
qualified — квалифицированный
338. question — вопрос
to question — ставить под сомнение
questionable — сомнительный
question mark — вопросительный знак
questionnaire — анкета
339. rational — рациональный
rationally — рационально / с умом
rationalism — рационализм
rationalize — рационализировать
rationalization — рационализация
340. real — реальный
realism — реализм
realist — реалист
reality — реальность
realize — осознать / реализовать
really — в самом деле
341. receive — получать
receiver — получатель / трубка телефона
receipt — квитанция
reception — стойка администратора (в гостинице)
receptionist — администратор
342. refer — относиться / ссылаться
referee — рефери / судья
reference — ссылка / упоминание
referendum — референдум
transfer — переводить
343. reform — реформа
transform — превращать
transformation — трансформация / преобразование
deform — деформировать
inform — информировать
conform —соответствовать / подчиняться
344. regular — регулярный / правильный / обычный
regularly — регулярно
regularity — регулярность
regulate — регулировать
regulation —директива / правило
345. relate — связывать с чем-то / относить к чему-то
related — связанный (с чем-то) / родственный
relation — отношение / связь
relationship — отношение
relative — относительный
a relative — родственник
346. reserve — сберегать
a reserve — запас / запасной игрок
reservation — заказ / бронирование
observation — комментарий
subservient — вспомогательный / подхалим
347. resist — сопротивляться
resistance — сопротивление
resistant — устойчивый
assist — помогать
insist — настаивать
348. to respect — уважать
respect — уважение / отношение
respectful — почтительный
aspect — аспект
suspect — подозревать
349. respond — отвечать
response — реакция / ответ
responsibility — ответственность
responsible — ответственный
responsive — отзывчивый
350. real — настоящий
realize — осознать / реализовать
realization —исполнение
reality — реальность
really — действительно
351. to reverse — изменить на противоположное / повернуть назад
reverse — обратный
reversal — изменение на противоположное
revert — менять(ся)
reversible — обратимый
version — версия
352. safe — надежный / безопасный
save — спасать
safety — надежность / безопасность
safeguard — охранять / гарантировать
savings — сбережения
353. sane — здравый / в своем уме
sanitary — санитарный
sanity — психическое здоровье
sanitation — санитария / оздоровление
sanatorium — санаторий
354. secret — секрет
secrecy — секретность
secretary — секретарь
secretive — скрытный
secretariat — секретариат
355. sell — продавать
sell out — распродавать
seller — продавец
best-seller — бестселлер
sale — продажа
salesman — торговец / продавец
356. sense — чувство / смысл
to sense — чувствовать
sensation — чувство / сенсация
senseless — бессмысленный
sensitive — чуткий / чувствительный
sensual — чувственный / сладострастный
357. separate — отдельный
to separate — отделять
separately — отдельно
separated — живущий отдельно (о супругах)
separation — разлука
358. sequel — продолжение
sequence — последовательность
consequence — последствие
consequent — вытекающий / последовательный
consequently — следовательно / последовательно
359. a set — комплект / набор
to set — помещать / ставить
set off — отправляться
set out — отправляться
setback — проблема / задержка
settee — диван
outset — начало
360. shame — стыд
shameful — постыдный
to shame — стыдить
shameless — бессовестный
shamefaced — стыдливый
361. ship — корабль
to ship — перевозить
shipping — суда / перевозка груза
shipwreck — кораблекрушение
shipyard — судоверфь
362. short — короткий
shorts — шорты
shortage — нехватка
shorten — сокращать
shortcoming — недостаток
short-cut — урезание / сокращение
short-sighted — близорукий
363. sick — больной
sicken — заболеть / чувствовать тошноту
sickening — вызывающий отвращение
sickness — болезнь / тошнота
sickly — болезненный
364. side — сторона
sideboard — буфет
sideline — боковая линия
sidelong — искоса
sidestep — отступать / отойти в сторону
siding — запасной путь
365. sign — знак
to sign — расписываться
signal — сигнал
signature — подпись / роспись
significant — значительный
signify — означать
366. simple — простой
simple-minded — простодушный
simplify — упрощать
simplicity — простота
simplification — упрощение
367. to sleep — спать
sleep — сон
sleeper — спящий / соня
sleepless — бессонный
sleepy — сонливый
sleeping pill — снотворное
368. to slip — засунуть / скользить
a slip — ошибка
slippers — комнатные тапочки
slippery' — скользкий
slipshod — неряшливый
369. show — показывать
a show — выставка / шоу
show off — красоваться / показывать в выгодном свете
show business — шоу-бизнес
showcase —витрина
370. social — социальный
sociable — общительный
society — общество
sociology — социология
social security — социальное обеспечение
371. soft — мягкий
soften — смягчаться
software — программное обеспечение
soft-hearted — мягкосердечный
softly — нежно
372. solicit — просить / ходатайствовать
solicitor — юрист
solicitous — заботливый
solicitude — забота / заботливость
soliciting — приставание
373. soluble — растворимый
solution — раствор
solve — решать (задачу)
solvent — платежеспособный
a solvent — растворитель
374. special — специальный
specialize — специализироваться
specially — специально
speciality — специальность / особенность
specialist — специалист
375. sight — зрение / вид
sighted — зрячий
sightseeing — осмотр достопримечательностей
sightseer — турист / экскурсант
far-sighted —дальновидный
376. speed — скорость
speed limit — ограничение скорости
speedy — быстрый / скорейший
speedometer — спидометр
speed up — ускорять
377. spirit — душа / настроение
spirits — спиртное
spirited — смелый / энергичный
spiritual — духовный
spirituality — духовность
378. sport — спорт
to sport — носить
sporting — спортивный
sportsman — спортсмен
sportswoman — спортсменка
379. stand — стоять
standing — положение / постоянный
standpoint — точка зрения
stand-offish — неприветливый
understand — понимать
380. stop — переставать / останавливаться
a stop — остановка
stopover — остановка / пребывание
stoppage — забастовка
stopwatch — секундомер
381. straight — прямой / прямо
straight away — сразу
straighten — выпрямить / поправить
straightforward — честный / прямой
straighten out — исправить
382. strain — растянуть / потянуть
a strain — натяжение / напряжение
strained — натянутый
constrain — принуждать / ограничивать
restrain — ограничивать
383. substance — вещество
substantial — существенный
substantiate — подтверждать
substantially — существенно
instance — пример
circumstance — обстоятельство
384. success — успех
successful — успешный
succession — последовательность / ряд
successive — следующий друг за другом
successor — преемник
succeed — преуспевать
proceed — продолжать / развиваться
process — процесс
385. sun — солнце
sunny — солнечный
sunrise — рассвет / восход солнца
sunset — заход солнца
sunbathe — загорать
386. super — высшего качества
superior — превосходящий
supernatural — сверхъестественный
supersonic — сверхзвуковой
superstar — суперзвезда
387. supervise — наблюдать / надзирать
supervision — надзор
revise — пересматривать / исправлять
revision — ревизия / пересмотр
televise — передавать по телевидению
devise — изобретать
388. suppose — предполагать
supposed — предполагаемый
supposition — предположение
disposition — характер / нрав
proposition — предложение
opposition — оппозиция
389. to suspect — подозревать
a suspect — подозреваемый (человек)
suspect — подозрительный
suspicion — подозрение
suspicious — подозрительный
390. tact — такт
tactful — тактичный
tactless — бестактный
tactic — тактика
tactical — тактический
391. taste — вкус
to taste — иметь вкус чего-то / пробовать на вкус
tasteful — сделанный со вкусом
tasteless — безвкусный
tasty — вкусный
392. think — думать
thinker — мыслитель
thinking — мышление
thought — мысль
thoughtless — бездумный
393. time — время
to time — назначать время
timeless — вечный / не относящийся к какому-то времени
timely — своевременный
timer — таймер
timetable — расписание
394. tolerate — дозволять / быть терпимым (к чему-то)
tolerable — терпимый / сносный
tolerant — проявляющий терпимость
tolerance — терпимость
toleration — терпимость
395. to turn — поворачивать / переворачивать
a turn — поворот / очередь / услуга
turning — поворот
turner — токарь
turnover — товарооборот
396. unit — единица
unite — объединяться
united — объединенный
unity — единство
397. use — использовать
the use — польза
usage — употребление
useful — полезный
useless — бесполезный
user — пользователь
398. vision — зрение / видение
visible — видимый
visibility — видимость
provision — снабжение
revision — ревизия / пересмотр
399. water — вода
to water — поливать
watercolour — акварель
watery — водянистый
waterworks — водопроводная станция
400. wit — ум / остроумие
witty — остроумный
sharp-witted — остроумный
dim-witted — тупой / глупый
witticism — острота
401. the work — работа
to work — работать
worker — рабочий / работник
working — рабочий (прилагательное)
workman — работник
workmanship —качество работы
worked up — расстроен / возбужден
