сочетании: глагол-связка to be (am, is, are и т. д.) + прилагательное + инфинитив стр 11

Инфинитив с to после прил((am, is, are и т. д.) + прилагательное + инфинитив)

able – способный 
afraid – боящийся 
anxious – сильно
желающий
ashamed – стыдящийся 
careful – внимательный 
dangerous – опасный 
difficult – трудный
disappointed – огорченный
eager – нетерпеливый
easy – нетрудный
frightened – напуганный
glad – радостный 
great – замечательный 
happy – счастливый
hard – трудный 
important – важный 
(im)possible – (не)возможный 
lucky – удачливый 
necessary – необходимый 
nice – хороший 
pleased – довольный
proud – гордый
ready – готовый 
right – правильный
sad – печальный
safe – безопасный
shocked – шокированный 
sorry – сожалеющий 
surprised – удивленный 
welcome – имеющий право 
willing – охотно делающий
wrong – неправильный
